,"Type","Date","Num","Memo","Name","Item","Qty","U/M","Sales Price","Amount","Balance"
"KROGER CORPORATE",,,,,,,,,,,""
"KROGER LOUISVILLE",,,,,,,,,,,""
"KROLO292",,,,,,,,,,,""
,"Invoice","10/10/2022","523353","810312-023693 / #23693 PRINTED SUP SOFT LEG S-L (L9316)","KROGER CORPORATE:KROGER LOUISVILLE:KROLO292","LISSL301-AY (810312-023693 / #23693 PRINTED SUP SOFT LEG S-L (L9316))",17,"EA",4.30,73.10,73.10
,"Invoice","10/10/2022","523353","810312-023709 / #23709 PRINTED SUP SOFT LEG L-XL (L9316)","KROGER CORPORATE:KROGER LOUISVILLE:KROLO292","LISSL302-AY (810312-023709 / #23709 PRINTED SUP SOFT LEG L-XL (L9316))",27,"EA",4.30,116.10,189.20
,"Invoice","10/10/2022","523353","810312-023716 / #23716 PRINTED SUP SOFT LEG 2XL-3XL (L9316)","KROGER CORPORATE:KROGER LOUISVILLE:KROLO292","LISSL303-AY (810312-023716 / #23716 PRINTED SUP SOFT LEG 2XL-3XL (L9316))",4,"EA",4.30,17.20,206.40
,"Invoice","11/07/2022","527963","810312-023662 / #23662 SOLID SUP SOFT LEG S-L (L6286)","KROGER CORPORATE:KROGER LOUISVILLE:KROLO292","LISSL201-AY (810312-023662 / #23662 SOLID SUP SOFT LEG S-L (L6286))",17,"EA",4.30,73.10,279.50
,"Invoice","11/07/2022","527963","810312-023679 / #23679 SOLID SUP SOFT LEG L-2XL (L6286)","KROGER CORPORATE:KROGER LOUISVILLE:KROLO292","LISSL202-AY (810312-023679 / #23679 SOLID SUP SOFT LEG L-2XL (L6286))",27,"EA",4.30,116.10,395.60
,"Invoice","11/07/2022","527963","810312-023686 / #23686 SOLID SUP SOFT LEG 2XL-3XL (L6286)","KROGER CORPORATE:KROGER LOUISVILLE:KROLO292","LISSL203-AY (810312-023686 / #23686 SOLID SUP SOFT LEG 2XL-3XL (L6286))",4,"EA",4.30,17.20,412.80
"Total KROLO292",,,,,,,96,,,412.80,412.80
"KROLO346",,,,,,,,,,,""
,"Invoice","10/03/2022","522676","810312-023693 / #23693 PRINTED SUP SOFT LEG S-L (L9316)","KROGER CORPORATE:KROGER LOUISVILLE:KROLO346","LISSL301-AY (810312-023693 / #23693 PRINTED SUP SOFT LEG S-L (L9316))",17,"EA",4.30,73.10,73.10
,"Invoice","10/03/2022","522676","810312-023709 / #23709 PRINTED SUP SOFT LEG L-XL (L9316)","KROGER CORPORATE:KROGER LOUISVILLE:KROLO346","LISSL302-AY (810312-023709 / #23709 PRINTED SUP SOFT LEG L-XL (L9316))",27,"EA",4.30,116.10,189.20
,"Invoice","10/03/2022","522676","810312-023716 / #23716 PRINTED SUP SOFT LEG 2XL-3XL (L9316)","KROGER CORPORATE:KROGER LOUISVILLE:KROLO346","LISSL303-AY (810312-023716 / #23716 PRINTED SUP SOFT LEG 2XL-3XL (L9316))",4,"EA",4.30,17.20,206.40
,"Invoice","10/10/2022","523352","810312-023723 / #23723 ORIGINAL DENIM JEGGING S-M (J3047)","KROGER CORPORATE:KROGER LOUISVILLE:KROLO346","LIODJ401-AY (810312-023723 / #23723 ORIGINAL DENIM JEGGING S-M (J3047))",13,"EA",10.50,136.50,342.90
,"Invoice","10/10/2022","523352","810312-023730 / #23730 ORIGINAL DENIM JEGGING L-XL (J3047)","KROGER CORPORATE:KROGER LOUISVILLE:KROLO346","LIODJ402-AY (810312-023730 / #23730 ORIGINAL DENIM JEGGING L-XL (J3047))",23,"EA",10.50,241.50,584.40
,"Invoice","10/10/2022","523352","810312-023747 / #23747 ORIGINAL DENIM JEGGING 2XL-3XL (J3047)","KROGER CORPORATE:KROGER LOUISVILLE:KROLO346","LIODJ403-AY (810312-023747 / #23747 ORIGINAL DENIM JEGGING 2XL-3XL (J3047))",4,"EA",10.50,42.00,626.40
,"Invoice","10/24/2022","524505","810312-023662 / #23662 SOLID SUP SOFT LEG S-L (L6286)","KROGER CORPORATE:KROGER LOUISVILLE:KROLO346","LISSL201-AY (810312-023662 / #23662 SOLID SUP SOFT LEG S-L (L6286))",17,"EA",4.30,73.10,699.50
,"Invoice","10/24/2022","524505","810312-023679 / #23679 SOLID SUP SOFT LEG L-2XL (L6286)","KROGER CORPORATE:KROGER LOUISVILLE:KROLO346","LISSL202-AY (810312-023679 / #23679 SOLID SUP SOFT LEG L-2XL (L6286))",27,"EA",4.30,116.10,815.60
,"Invoice","10/24/2022","524505","810312-023686 / #23686 SOLID SUP SOFT LEG 2XL-3XL (L6286)","KROGER CORPORATE:KROGER LOUISVILLE:KROLO346","LISSL203-AY (810312-023686 / #23686 SOLID SUP SOFT LEG 2XL-3XL (L6286))",4,"EA",4.30,17.20,832.80
,"Invoice","11/07/2022","527962","810312-023846 / #23846 PRINTED JEGGING S-M (J4660)","KROGER CORPORATE:KROGER LOUISVILLE:KROLO346","LIPDJ301-AY (810312-023846 / #23846 PRINTED JEGGING S-M (J4660))",13,"EA",10.50,136.50,969.30
,"Invoice","11/07/2022","527962","810312-023853/ #23853 PRINTED JEGGING L-XL (J4660)","KROGER CORPORATE:KROGER LOUISVILLE:KROLO346","LIPDJ302-AY (810312-023853/ #23853 PRINTED JEGGING L-XL (J4660))",23,"EA",10.50,241.50,1210.80
,"Invoice","11/07/2022","527962","810312-023860/ #23860 PRINTED JEGGING 2XL-3XL (J4660)","KROGER CORPORATE:KROGER LOUISVILLE:KROLO346","LIPDJ303-AY (810312-023860/ #23860 PRINTED JEGGING 2XL-3XL (J4660))",4,"EA",10.50,42.00,1252.80
"Total KROLO346",,,,,,,176,,,1252.80,1252.80
"KROLO356",,,,,,,,,,,""
,"Invoice","10/03/2022","522670","810312-023723 / #23723 ORIGINAL DENIM JEGGING S-M (J3047)","KROGER CORPORATE:KROGER LOUISVILLE:KROLO356","LIODJ401-AY (810312-023723 / #23723 ORIGINAL DENIM JEGGING S-M (J3047))",13,"EA",10.50,136.50,136.50
,"Invoice","10/03/2022","522670","810312-023730 / #23730 ORIGINAL DENIM JEGGING L-XL (J3047)","KROGER CORPORATE:KROGER LOUISVILLE:KROLO356","LIODJ402-AY (810312-023730 / #23730 ORIGINAL DENIM JEGGING L-XL (J3047))",23,"EA",10.50,241.50,378.00
,"Invoice","10/03/2022","522670","810312-023747 / #23747 ORIGINAL DENIM JEGGING 2XL-3XL (J3047)","KROGER CORPORATE:KROGER LOUISVILLE:KROLO356","LIODJ403-AY (810312-023747 / #23747 ORIGINAL DENIM JEGGING 2XL-3XL (J3047))",4,"EA",10.50,42.00,420.00
,"Invoice","10/24/2022","524504","810312-023662 / #23662 SOLID SUP SOFT LEG S-L (L6286)","KROGER CORPORATE:KROGER LOUISVILLE:KROLO356","LISSL201-AY (810312-023662 / #23662 SOLID SUP SOFT LEG S-L (L6286))",17,"EA",4.30,73.10,493.10
,"Invoice","10/24/2022","524504","810312-023679 / #23679 SOLID SUP SOFT LEG L-2XL (L6286)","KROGER CORPORATE:KROGER LOUISVILLE:KROLO356","LISSL202-AY (810312-023679 / #23679 SOLID SUP SOFT LEG L-2XL (L6286))",27,"EA",4.30,116.10,609.20
,"Invoice","10/24/2022","524504","810312-023686 / #23686 SOLID SUP SOFT LEG 2XL-3XL (L6286)","KROGER CORPORATE:KROGER LOUISVILLE:KROLO356","LISSL203-AY (810312-023686 / #23686 SOLID SUP SOFT LEG 2XL-3XL (L6286))",4,"EA",4.30,17.20,626.40
,"Invoice","11/07/2022","527965","810312-023693 / #23693 PRINTED SUP SOFT LEG S-L (L9316)","KROGER CORPORATE:KROGER LOUISVILLE:KROLO356","LISSL301-AY (810312-023693 / #23693 PRINTED SUP SOFT LEG S-L (L9316))",17,"EA",4.30,73.10,699.50
,"Invoice","11/07/2022","527965","810312-023709 / #23709 PRINTED SUP SOFT LEG L-XL (L9316)","KROGER CORPORATE:KROGER LOUISVILLE:KROLO356","LISSL302-AY (810312-023709 / #23709 PRINTED SUP SOFT LEG L-XL (L9316))",27,"EA",4.30,116.10,815.60
,"Invoice","11/07/2022","527965","810312-023716 / #23716 PRINTED SUP SOFT LEG 2XL-3XL (L9316)","KROGER CORPORATE:KROGER LOUISVILLE:KROLO356","LISSL303-AY (810312-023716 / #23716 PRINTED SUP SOFT LEG 2XL-3XL (L9316))",4,"EA",4.30,17.20,832.80
"Total KROLO356",,,,,,,136,,,832.80,832.80
"KROLO379",,,,,,,,,,,""
,"Invoice","10/03/2022","522674","810312-023846 / #23846 PRINTED JEGGING S-M (J4660)","KROGER CORPORATE:KROGER LOUISVILLE:KROLO379","LIPDJ301-AY (810312-023846 / #23846 PRINTED JEGGING S-M (J4660))",13,"EA",10.50,136.50,136.50
,"Invoice","10/03/2022","522674","810312-023853/ #23853 PRINTED JEGGING L-XL (J4660)","KROGER CORPORATE:KROGER LOUISVILLE:KROLO379","LIPDJ302-AY (810312-023853/ #23853 PRINTED JEGGING L-XL (J4660))",23,"EA",10.50,241.50,378.00
,"Invoice","10/03/2022","522674","810312-023860/ #23860 PRINTED JEGGING 2XL-3XL (J4660)","KROGER CORPORATE:KROGER LOUISVILLE:KROLO379","LIPDJ303-AY (810312-023860/ #23860 PRINTED JEGGING 2XL-3XL (J4660))",4,"EA",10.50,42.00,420.00
,"Invoice","10/10/2022","523358","810312-023662 / #23662 SOLID SUP SOFT LEG S-L (L6286)","KROGER CORPORATE:KROGER LOUISVILLE:KROLO379","LISSL201-AY (810312-023662 / #23662 SOLID SUP SOFT LEG S-L (L6286))",17,"EA",4.30,73.10,493.10
,"Invoice","10/10/2022","523358","810312-023679 / #23679 SOLID SUP SOFT LEG L-2XL (L6286)","KROGER CORPORATE:KROGER LOUISVILLE:KROLO379","LISSL202-AY (810312-023679 / #23679 SOLID SUP SOFT LEG L-2XL (L6286))",27,"EA",4.30,116.10,609.20
,"Invoice","10/10/2022","523358","810312-023686 / #23686 SOLID SUP SOFT LEG 2XL-3XL (L6286)","KROGER CORPORATE:KROGER LOUISVILLE:KROLO379","LISSL203-AY (810312-023686 / #23686 SOLID SUP SOFT LEG 2XL-3XL (L6286))",4,"EA",4.30,17.20,626.40
,"Invoice","11/01/2022","527079","810312-023693 / #23693 PRINTED SUP SOFT LEG S-L (L9316)","KROGER CORPORATE:KROGER LOUISVILLE:KROLO379","LISSL301-AY (810312-023693 / #23693 PRINTED SUP SOFT LEG S-L (L9316))",17,"EA",4.30,73.10,699.50
,"Invoice","11/01/2022","527079","810312-023709 / #23709 PRINTED SUP SOFT LEG L-XL (L9316)","KROGER CORPORATE:KROGER LOUISVILLE:KROLO379","LISSL302-AY (810312-023709 / #23709 PRINTED SUP SOFT LEG L-XL (L9316))",27,"EA",4.30,116.10,815.60
,"Invoice","11/01/2022","527079","810312-023716 / #23716 PRINTED SUP SOFT LEG 2XL-3XL (L9316)","KROGER CORPORATE:KROGER LOUISVILLE:KROLO379","LISSL303-AY (810312-023716 / #23716 PRINTED SUP SOFT LEG 2XL-3XL (L9316))",4,"EA",4.30,17.20,832.80
"Total KROLO379",,,,,,,136,,,832.80,832.80
"KROLO396",,,,,,,,,,,""
,"Invoice","11/01/2022","527081","810312-023662 / #23662 SOLID SUP SOFT LEG S-L (L6286)","KROGER CORPORATE:KROGER LOUISVILLE:KROLO396","LISSL201-AY (810312-023662 / #23662 SOLID SUP SOFT LEG S-L (L6286))",17,"EA",4.30,73.10,73.10
,"Invoice","11/01/2022","527081","810312-023679 / #23679 SOLID SUP SOFT LEG L-2XL (L6286)","KROGER CORPORATE:KROGER LOUISVILLE:KROLO396","LISSL202-AY (810312-023679 / #23679 SOLID SUP SOFT LEG L-2XL (L6286))",27,"EA",4.30,116.10,189.20
,"Invoice","11/01/2022","527081","810312-023686 / #23686 SOLID SUP SOFT LEG 2XL-3XL (L6286)","KROGER CORPORATE:KROGER LOUISVILLE:KROLO396","LISSL203-AY (810312-023686 / #23686 SOLID SUP SOFT LEG 2XL-3XL (L6286))",4,"EA",4.30,17.20,206.40
"Total KROLO396",,,,,,,48,,,206.40,206.40
"KROLO397",,,,,,,,,,,""
,"Invoice","10/17/2022","524020","810312-023723 / #23723 ORIGINAL DENIM JEGGING S-M (J3047)","KROGER CORPORATE:KROGER LOUISVILLE:KROLO397","LIODJ401-AY (810312-023723 / #23723 ORIGINAL DENIM JEGGING S-M (J3047))",13,"EA",10.50,136.50,136.50
,"Invoice","10/17/2022","524020","810312-023730 / #23730 ORIGINAL DENIM JEGGING L-XL (J3047)","KROGER CORPORATE:KROGER LOUISVILLE:KROLO397","LIODJ402-AY (810312-023730 / #23730 ORIGINAL DENIM JEGGING L-XL (J3047))",23,"EA",10.50,241.50,378.00
,"Invoice","10/17/2022","524020","810312-023747 / #23747 ORIGINAL DENIM JEGGING 2XL-3XL (J3047)","KROGER CORPORATE:KROGER LOUISVILLE:KROLO397","LIODJ403-AY (810312-023747 / #23747 ORIGINAL DENIM JEGGING 2XL-3XL (J3047))",4,"EA",10.50,42.00,420.00
"Total KROLO397",,,,,,,40,,,420.00,420.00
"KROLO407",,,,,,,,,,,""
,"Invoice","10/03/2022","522677","810312-023693 / #23693 PRINTED SUP SOFT LEG S-L (L9316)","KROGER CORPORATE:KROGER LOUISVILLE:KROLO407","LISSL301-AY (810312-023693 / #23693 PRINTED SUP SOFT LEG S-L (L9316))",17,"EA",4.30,73.10,73.10
,"Invoice","10/03/2022","522677","810312-023709 / #23709 PRINTED SUP SOFT LEG L-XL (L9316)","KROGER CORPORATE:KROGER LOUISVILLE:KROLO407","LISSL302-AY (810312-023709 / #23709 PRINTED SUP SOFT LEG L-XL (L9316))",27,"EA",4.30,116.10,189.20
,"Invoice","10/03/2022","522677","810312-023716 / #23716 PRINTED SUP SOFT LEG 2XL-3XL (L9316)","KROGER CORPORATE:KROGER LOUISVILLE:KROLO407","LISSL303-AY (810312-023716 / #23716 PRINTED SUP SOFT LEG 2XL-3XL (L9316))",4,"EA",4.30,17.20,206.40
,"Invoice","10/10/2022","523359","810312-023662 / #23662 SOLID SUP SOFT LEG S-L (L6286)","KROGER CORPORATE:KROGER LOUISVILLE:KROLO407","LISSL201-AY (810312-023662 / #23662 SOLID SUP SOFT LEG S-L (L6286))",17,"EA",4.30,73.10,279.50
,"Invoice","10/10/2022","523359","810312-023679 / #23679 SOLID SUP SOFT LEG L-2XL (L6286)","KROGER CORPORATE:KROGER LOUISVILLE:KROLO407","LISSL202-AY (810312-023679 / #23679 SOLID SUP SOFT LEG L-2XL (L6286))",27,"EA",4.30,116.10,395.60
,"Invoice","10/10/2022","523359","810312-023686 / #23686 SOLID SUP SOFT LEG 2XL-3XL (L6286)","KROGER CORPORATE:KROGER LOUISVILLE:KROLO407","LISSL203-AY (810312-023686 / #23686 SOLID SUP SOFT LEG 2XL-3XL (L6286))",4,"EA",4.30,17.20,412.80
,"Invoice","10/24/2022","524499","810312-023723 / #23723 ORIGINAL DENIM JEGGING S-M (J3047)","KROGER CORPORATE:KROGER LOUISVILLE:KROLO407","LIODJ401-AY (810312-023723 / #23723 ORIGINAL DENIM JEGGING S-M (J3047))",13,"EA",10.50,136.50,549.30
,"Invoice","10/24/2022","524499","810312-023730 / #23730 ORIGINAL DENIM JEGGING L-XL (J3047)","KROGER CORPORATE:KROGER LOUISVILLE:KROLO407","LIODJ402-AY (810312-023730 / #23730 ORIGINAL DENIM JEGGING L-XL (J3047))",23,"EA",10.50,241.50,790.80
,"Invoice","10/24/2022","524499","810312-023747 / #23747 ORIGINAL DENIM JEGGING 2XL-3XL (J3047)","KROGER CORPORATE:KROGER LOUISVILLE:KROLO407","LIODJ403-AY (810312-023747 / #23747 ORIGINAL DENIM JEGGING 2XL-3XL (J3047))",4,"EA",10.50,42.00,832.80
"Total KROLO407",,,,,,,136,,,832.80,832.80
"KROLO408",,,,,,,,,,,""
,"Invoice","10/10/2022","523355","810312-023846 / #23846 PRINTED JEGGING S-M (J4660)","KROGER CORPORATE:KROGER LOUISVILLE:KROLO408","LIPDJ301-AY (810312-023846 / #23846 PRINTED JEGGING S-M (J4660))",13,"EA",10.50,136.50,136.50
,"Invoice","10/10/2022","523355","810312-023853/ #23853 PRINTED JEGGING L-XL (J4660)","KROGER CORPORATE:KROGER LOUISVILLE:KROLO408","LIPDJ302-AY (810312-023853/ #23853 PRINTED JEGGING L-XL (J4660))",23,"EA",10.50,241.50,378.00
,"Invoice","10/10/2022","523355","810312-023860/ #23860 PRINTED JEGGING 2XL-3XL (J4660)","KROGER CORPORATE:KROGER LOUISVILLE:KROLO408","LIPDJ303-AY (810312-023860/ #23860 PRINTED JEGGING 2XL-3XL (J4660))",4,"EA",10.50,42.00,420.00
,"Invoice","11/01/2022","527077","810312-023723 / #23723 ORIGINAL DENIM JEGGING S-M (J3047)","KROGER CORPORATE:KROGER LOUISVILLE:KROLO408","LIODJ401-AY (810312-023723 / #23723 ORIGINAL DENIM JEGGING S-M (J3047))",13,"EA",10.50,136.50,556.50
,"Invoice","11/01/2022","527077","810312-023730 / #23730 ORIGINAL DENIM JEGGING L-XL (J3047)","KROGER CORPORATE:KROGER LOUISVILLE:KROLO408","LIODJ402-AY (810312-023730 / #23730 ORIGINAL DENIM JEGGING L-XL (J3047))",23,"EA",10.50,241.50,798.00
,"Invoice","11/01/2022","527077","810312-023747 / #23747 ORIGINAL DENIM JEGGING 2XL-3XL (J3047)","KROGER CORPORATE:KROGER LOUISVILLE:KROLO408","LIODJ403-AY (810312-023747 / #23747 ORIGINAL DENIM JEGGING 2XL-3XL (J3047))",4,"EA",10.50,42.00,840.00
"Total KROLO408",,,,,,,80,,,840.00,840.00
"KROLO705",,,,,,,,,,,""
,"Invoice","10/10/2022","523356","810312-023662 / #23662 SOLID SUP SOFT LEG S-L (L6286)","KROGER CORPORATE:KROGER LOUISVILLE:KROLO705","LISSL201-AY (810312-023662 / #23662 SOLID SUP SOFT LEG S-L (L6286))",17,"EA",4.30,73.10,73.10
,"Invoice","10/10/2022","523356","810312-023679 / #23679 SOLID SUP SOFT LEG L-2XL (L6286)","KROGER CORPORATE:KROGER LOUISVILLE:KROLO705","LISSL202-AY (810312-023679 / #23679 SOLID SUP SOFT LEG L-2XL (L6286))",27,"EA",4.30,116.10,189.20
,"Invoice","10/10/2022","523356","810312-023686 / #23686 SOLID SUP SOFT LEG 2XL-3XL (L6286)","KROGER CORPORATE:KROGER LOUISVILLE:KROLO705","LISSL203-AY (810312-023686 / #23686 SOLID SUP SOFT LEG 2XL-3XL (L6286))",4,"EA",4.30,17.20,206.40
,"Invoice","10/24/2022","524502","810312-023846 / #23846 PRINTED JEGGING S-M (J4660)","KROGER CORPORATE:KROGER LOUISVILLE:KROLO705","LIPDJ301-AY (810312-023846 / #23846 PRINTED JEGGING S-M (J4660))",13,"EA",10.50,136.50,342.90
,"Invoice","10/24/2022","524502","810312-023853/ #23853 PRINTED JEGGING L-XL (J4660)","KROGER CORPORATE:KROGER LOUISVILLE:KROLO705","LIPDJ302-AY (810312-023853/ #23853 PRINTED JEGGING L-XL (J4660))",23,"EA",10.50,241.50,584.40
,"Invoice","10/24/2022","524502","810312-023860/ #23860 PRINTED JEGGING 2XL-3XL (J4660)","KROGER CORPORATE:KROGER LOUISVILLE:KROLO705","LIPDJ303-AY (810312-023860/ #23860 PRINTED JEGGING 2XL-3XL (J4660))",4,"EA",10.50,42.00,626.40
,"Invoice","11/01/2022","527080","810312-023662 / #23662 SOLID SUP SOFT LEG S-L (L6286)","KROGER CORPORATE:KROGER LOUISVILLE:KROLO705","LISSL201-AY (810312-023662 / #23662 SOLID SUP SOFT LEG S-L (L6286))",17,"EA",4.30,73.10,699.50
,"Invoice","11/01/2022","527080","810312-023679 / #23679 SOLID SUP SOFT LEG L-2XL (L6286)","KROGER CORPORATE:KROGER LOUISVILLE:KROLO705","LISSL202-AY (810312-023679 / #23679 SOLID SUP SOFT LEG L-2XL (L6286))",27,"EA",4.30,116.10,815.60
,"Invoice","11/01/2022","527080","810312-023686 / #23686 SOLID SUP SOFT LEG 2XL-3XL (L6286)","KROGER CORPORATE:KROGER LOUISVILLE:KROLO705","LISSL203-AY (810312-023686 / #23686 SOLID SUP SOFT LEG 2XL-3XL (L6286))",4,"EA",4.30,17.20,832.80
"Total KROLO705",,,,,,,136,,,832.80,832.80
"KROLO707",,,,,,,,,,,""
,"Invoice","10/03/2022","522675","810312-023662 / #23662 SOLID SUP SOFT LEG S-L (L6286)","KROGER CORPORATE:KROGER LOUISVILLE:KROLO707","LISSL201-AY (810312-023662 / #23662 SOLID SUP SOFT LEG S-L (L6286))",17,"EA",4.30,73.10,73.10
,"Invoice","10/03/2022","522675","810312-023679 / #23679 SOLID SUP SOFT LEG L-2XL (L6286)","KROGER CORPORATE:KROGER LOUISVILLE:KROLO707","LISSL202-AY (810312-023679 / #23679 SOLID SUP SOFT LEG L-2XL (L6286))",27,"EA",4.30,116.10,189.20
,"Invoice","10/03/2022","522675","810312-023686 / #23686 SOLID SUP SOFT LEG 2XL-3XL (L6286)","KROGER CORPORATE:KROGER LOUISVILLE:KROLO707","LISSL203-AY (810312-023686 / #23686 SOLID SUP SOFT LEG 2XL-3XL (L6286))",4,"EA",4.30,17.20,206.40
"Total KROLO707",,,,,,,48,,,206.40,206.40
"KROLO717",,,,,,,,,,,""
,"Invoice","10/10/2022","523360","810312-023662 / #23662 SOLID SUP SOFT LEG S-L (L6286)","KROGER CORPORATE:KROGER LOUISVILLE:KROLO717","LISSL201-AY (810312-023662 / #23662 SOLID SUP SOFT LEG S-L (L6286))",17,"EA",4.30,73.10,73.10
,"Invoice","10/10/2022","523360","810312-023679 / #23679 SOLID SUP SOFT LEG L-2XL (L6286)","KROGER CORPORATE:KROGER LOUISVILLE:KROLO717","LISSL202-AY (810312-023679 / #23679 SOLID SUP SOFT LEG L-2XL (L6286))",27,"EA",4.30,116.10,189.20
,"Invoice","10/10/2022","523360","810312-023686 / #23686 SOLID SUP SOFT LEG 2XL-3XL (L6286)","KROGER CORPORATE:KROGER LOUISVILLE:KROLO717","LISSL203-AY (810312-023686 / #23686 SOLID SUP SOFT LEG 2XL-3XL (L6286))",4,"EA",4.30,17.20,206.40
,"Invoice","11/01/2022","527078","810312-023723 / #23723 ORIGINAL DENIM JEGGING S-M (J3047)","KROGER CORPORATE:KROGER LOUISVILLE:KROLO717","LIODJ401-AY (810312-023723 / #23723 ORIGINAL DENIM JEGGING S-M (J3047))",13,"EA",10.50,136.50,342.90
,"Invoice","11/01/2022","527078","810312-023730 / #23730 ORIGINAL DENIM JEGGING L-XL (J3047)","KROGER CORPORATE:KROGER LOUISVILLE:KROLO717","LIODJ402-AY (810312-023730 / #23730 ORIGINAL DENIM JEGGING L-XL (J3047))",23,"EA",10.50,241.50,584.40
,"Invoice","11/01/2022","527078","810312-023747 / #23747 ORIGINAL DENIM JEGGING 2XL-3XL (J3047)","KROGER CORPORATE:KROGER LOUISVILLE:KROLO717","LIODJ403-AY (810312-023747 / #23747 ORIGINAL DENIM JEGGING 2XL-3XL (J3047))",4,"EA",10.50,42.00,626.40
"Total KROLO717",,,,,,,88,,,626.40,626.40
"KROLO745",,,,,,,,,,,""
,"Invoice","10/24/2022","524498","810312-023723 / #23723 ORIGINAL DENIM JEGGING S-M (J3047)","KROGER CORPORATE:KROGER LOUISVILLE:KROLO745","LIODJ401-AY (810312-023723 / #23723 ORIGINAL DENIM JEGGING S-M (J3047))",13,"EA",10.50,136.50,136.50
,"Invoice","10/24/2022","524498","810312-023730 / #23730 ORIGINAL DENIM JEGGING L-XL (J3047)","KROGER CORPORATE:KROGER LOUISVILLE:KROLO745","LIODJ402-AY (810312-023730 / #23730 ORIGINAL DENIM JEGGING L-XL (J3047))",23,"EA",10.50,241.50,378.00
,"Invoice","10/24/2022","524498","810312-023747 / #23747 ORIGINAL DENIM JEGGING 2XL-3XL (J3047)","KROGER CORPORATE:KROGER LOUISVILLE:KROLO745","LIODJ403-AY (810312-023747 / #23747 ORIGINAL DENIM JEGGING 2XL-3XL (J3047))",4,"EA",10.50,42.00,420.00
"Total KROLO745",,,,,,,40,,,420.00,420.00
"KROLO766",,,,,,,,,,,""
,"Invoice","10/17/2022","524022","810312-023693 / #23693 PRINTED SUP SOFT LEG S-L (L9316)","KROGER CORPORATE:KROGER LOUISVILLE:KROLO766","LISSL301-AY (810312-023693 / #23693 PRINTED SUP SOFT LEG S-L (L9316))",17,"EA",4.30,73.10,73.10
,"Invoice","10/17/2022","524022","810312-023709 / #23709 PRINTED SUP SOFT LEG L-XL (L9316)","KROGER CORPORATE:KROGER LOUISVILLE:KROLO766","LISSL302-AY (810312-023709 / #23709 PRINTED SUP SOFT LEG L-XL (L9316))",27,"EA",4.30,116.10,189.20
,"Invoice","10/17/2022","524022","810312-023716 / #23716 PRINTED SUP SOFT LEG 2XL-3XL (L9316)","KROGER CORPORATE:KROGER LOUISVILLE:KROLO766","LISSL303-AY (810312-023716 / #23716 PRINTED SUP SOFT LEG 2XL-3XL (L9316))",4,"EA",4.30,17.20,206.40
"Total KROLO766",,,,,,,48,,,206.40,206.40
"KROLO767",,,,,,,,,,,""
,"Invoice","10/10/2022","523354","810312-023846 / #23846 PRINTED JEGGING S-M (J4660)","KROGER CORPORATE:KROGER LOUISVILLE:KROLO767","LIPDJ301-AY (810312-023846 / #23846 PRINTED JEGGING S-M (J4660))",13,"EA",10.50,136.50,136.50
,"Invoice","10/10/2022","523354","810312-023853/ #23853 PRINTED JEGGING L-XL (J4660)","KROGER CORPORATE:KROGER LOUISVILLE:KROLO767","LIPDJ302-AY (810312-023853/ #23853 PRINTED JEGGING L-XL (J4660))",23,"EA",10.50,241.50,378.00
,"Invoice","10/10/2022","523354","810312-023860/ #23860 PRINTED JEGGING 2XL-3XL (J4660)","KROGER CORPORATE:KROGER LOUISVILLE:KROLO767","LIPDJ303-AY (810312-023860/ #23860 PRINTED JEGGING 2XL-3XL (J4660))",4,"EA",10.50,42.00,420.00
,"Credit Memo","10/16/2022","523929","810312-023662 / #23662 SOLID SUP SOFT LEG S-L (L6286)","KROGER CORPORATE:KROGER LOUISVILLE:KROLO767","LISSL201-AY (810312-023662 / #23662 SOLID SUP SOFT LEG S-L (L6286))",-17,,4.30,-73.10,346.90
,"Credit Memo","10/16/2022","523929","810312-023679 / #23679 SOLID SUP SOFT LEG L-2XL (L6286)","KROGER CORPORATE:KROGER LOUISVILLE:KROLO767","LISSL202-AY (810312-023679 / #23679 SOLID SUP SOFT LEG L-2XL (L6286))",-27,,4.30,-116.10,230.80
,"Credit Memo","10/16/2022","523929","810312-023686 / #23686 SOLID SUP SOFT LEG 2XL-3XL (L6286)","KROGER CORPORATE:KROGER LOUISVILLE:KROLO767","LISSL203-AY (810312-023686 / #23686 SOLID SUP SOFT LEG 2XL-3XL (L6286))",-4,,4.30,-17.20,213.60
,"Invoice","10/17/2022","524019","810312-023723 / #23723 ORIGINAL DENIM JEGGING S-M (J3047)","KROGER CORPORATE:KROGER LOUISVILLE:KROLO767","LIODJ401-AY (810312-023723 / #23723 ORIGINAL DENIM JEGGING S-M (J3047))",13,"EA",10.50,136.50,350.10
,"Invoice","10/17/2022","524019","810312-023730 / #23730 ORIGINAL DENIM JEGGING L-XL (J3047)","KROGER CORPORATE:KROGER LOUISVILLE:KROLO767","LIODJ402-AY (810312-023730 / #23730 ORIGINAL DENIM JEGGING L-XL (J3047))",23,"EA",10.50,241.50,591.60
,"Invoice","10/17/2022","524019","810312-023747 / #23747 ORIGINAL DENIM JEGGING 2XL-3XL (J3047)","KROGER CORPORATE:KROGER LOUISVILLE:KROLO767","LIODJ403-AY (810312-023747 / #23747 ORIGINAL DENIM JEGGING 2XL-3XL (J3047))",4,"EA",10.50,42.00,633.60
,"Invoice","11/07/2022","527964","810312-023693 / #23693 PRINTED SUP SOFT LEG S-L (L9316)","KROGER CORPORATE:KROGER LOUISVILLE:KROLO767","LISSL301-AY (810312-023693 / #23693 PRINTED SUP SOFT LEG S-L (L9316))",17,"EA",4.30,73.10,706.70
,"Invoice","11/07/2022","527964","810312-023709 / #23709 PRINTED SUP SOFT LEG L-XL (L9316)","KROGER CORPORATE:KROGER LOUISVILLE:KROLO767","LISSL302-AY (810312-023709 / #23709 PRINTED SUP SOFT LEG L-XL (L9316))",27,"EA",4.30,116.10,822.80
,"Invoice","11/07/2022","527964","810312-023716 / #23716 PRINTED SUP SOFT LEG 2XL-3XL (L9316)","KROGER CORPORATE:KROGER LOUISVILLE:KROLO767","LISSL303-AY (810312-023716 / #23716 PRINTED SUP SOFT LEG 2XL-3XL (L9316))",4,"EA",4.30,17.20,840.00
"Total KROLO767",,,,,,,80,,,840.00,840.00
"KROLO770",,,,,,,,,,,""
,"Invoice","10/24/2022","524506","810312-023662 / #23662 SOLID SUP SOFT LEG S-L (L6286)","KROGER CORPORATE:KROGER LOUISVILLE:KROLO770","LISSL201-AY (810312-023662 / #23662 SOLID SUP SOFT LEG S-L (L6286))",17,"EA",4.30,73.10,73.10
,"Invoice","10/24/2022","524506","810312-023679 / #23679 SOLID SUP SOFT LEG L-2XL (L6286)","KROGER CORPORATE:KROGER LOUISVILLE:KROLO770","LISSL202-AY (810312-023679 / #23679 SOLID SUP SOFT LEG L-2XL (L6286))",27,"EA",4.30,116.10,189.20
,"Invoice","10/24/2022","524506","810312-023686 / #23686 SOLID SUP SOFT LEG 2XL-3XL (L6286)","KROGER CORPORATE:KROGER LOUISVILLE:KROLO770","LISSL203-AY (810312-023686 / #23686 SOLID SUP SOFT LEG 2XL-3XL (L6286))",4,"EA",4.30,17.20,206.40
"Total KROLO770",,,,,,,48,,,206.40,206.40
"KROLO774",,,,,,,,,,,""
,"Invoice","10/17/2022","524021","810312-023662 / #23662 SOLID SUP SOFT LEG S-L (L6286)","KROGER CORPORATE:KROGER LOUISVILLE:KROLO774","LISSL201-AY (810312-023662 / #23662 SOLID SUP SOFT LEG S-L (L6286))",17,"EA",4.30,73.10,73.10
,"Invoice","10/17/2022","524021","810312-023679 / #23679 SOLID SUP SOFT LEG L-2XL (L6286)","KROGER CORPORATE:KROGER LOUISVILLE:KROLO774","LISSL202-AY (810312-023679 / #23679 SOLID SUP SOFT LEG L-2XL (L6286))",27,"EA",4.30,116.10,189.20
,"Invoice","10/17/2022","524021","810312-023686 / #23686 SOLID SUP SOFT LEG 2XL-3XL (L6286)","KROGER CORPORATE:KROGER LOUISVILLE:KROLO774","LISSL203-AY (810312-023686 / #23686 SOLID SUP SOFT LEG 2XL-3XL (L6286))",4,"EA",4.30,17.20,206.40
,"Invoice","11/07/2022","527960","810312-023723 / #23723 ORIGINAL DENIM JEGGING S-M (J3047)","KROGER CORPORATE:KROGER LOUISVILLE:KROLO774","LIODJ401-AY (810312-023723 / #23723 ORIGINAL DENIM JEGGING S-M (J3047))",13,"EA",10.50,136.50,342.90
,"Invoice","11/07/2022","527960","810312-023730 / #23730 ORIGINAL DENIM JEGGING L-XL (J3047)","KROGER CORPORATE:KROGER LOUISVILLE:KROLO774","LIODJ402-AY (810312-023730 / #23730 ORIGINAL DENIM JEGGING L-XL (J3047))",23,"EA",10.50,241.50,584.40
,"Invoice","11/07/2022","527960","810312-023747 / #23747 ORIGINAL DENIM JEGGING 2XL-3XL (J3047)","KROGER CORPORATE:KROGER LOUISVILLE:KROLO774","LIODJ403-AY (810312-023747 / #23747 ORIGINAL DENIM JEGGING 2XL-3XL (J3047))",4,"EA",10.50,42.00,626.40
"Total KROLO774",,,,,,,88,,,626.40,626.40
"KROLO776",,,,,,,,,,,""
,"Invoice","10/03/2022","522671","810312-023723 / #23723 ORIGINAL DENIM JEGGING S-M (J3047)","KROGER CORPORATE:KROGER LOUISVILLE:KROLO776","LIODJ401-AY (810312-023723 / #23723 ORIGINAL DENIM JEGGING S-M (J3047))",13,"EA",10.50,136.50,136.50
,"Invoice","10/03/2022","522671","810312-023730 / #23730 ORIGINAL DENIM JEGGING L-XL (J3047)","KROGER CORPORATE:KROGER LOUISVILLE:KROLO776","LIODJ402-AY (810312-023730 / #23730 ORIGINAL DENIM JEGGING L-XL (J3047))",23,"EA",10.50,241.50,378.00
,"Invoice","10/03/2022","522671","810312-023747 / #23747 ORIGINAL DENIM JEGGING 2XL-3XL (J3047)","KROGER CORPORATE:KROGER LOUISVILLE:KROLO776","LIODJ403-AY (810312-023747 / #23747 ORIGINAL DENIM JEGGING 2XL-3XL (J3047))",4,"EA",10.50,42.00,420.00
,"Invoice","10/24/2022","524503","810312-023846 / #23846 PRINTED JEGGING S-M (J4660)","KROGER CORPORATE:KROGER LOUISVILLE:KROLO776","LIPDJ301-AY (810312-023846 / #23846 PRINTED JEGGING S-M (J4660))",13,"EA",10.50,136.50,556.50
,"Invoice","10/24/2022","524503","810312-023853/ #23853 PRINTED JEGGING L-XL (J4660)","KROGER CORPORATE:KROGER LOUISVILLE:KROLO776","LIPDJ302-AY (810312-023853/ #23853 PRINTED JEGGING L-XL (J4660))",23,"EA",10.50,241.50,798.00
,"Invoice","10/24/2022","524503","810312-023860/ #23860 PRINTED JEGGING 2XL-3XL (J4660)","KROGER CORPORATE:KROGER LOUISVILLE:KROLO776","LIPDJ303-AY (810312-023860/ #23860 PRINTED JEGGING 2XL-3XL (J4660))",4,"EA",10.50,42.00,840.00
"Total KROLO776",,,,,,,80,,,840.00,840.00
"KROLO777",,,,,,,,,,,""
,"Invoice","10/03/2022","522673","810312-023723 / #23723 ORIGINAL DENIM JEGGING S-M (J3047)","KROGER CORPORATE:KROGER LOUISVILLE:KROLO777","LIODJ401-AY (810312-023723 / #23723 ORIGINAL DENIM JEGGING S-M (J3047))",13,"EA",10.50,136.50,136.50
,"Invoice","10/03/2022","522673","810312-023730 / #23730 ORIGINAL DENIM JEGGING L-XL (J3047)","KROGER CORPORATE:KROGER LOUISVILLE:KROLO777","LIODJ402-AY (810312-023730 / #23730 ORIGINAL DENIM JEGGING L-XL (J3047))",23,"EA",10.50,241.50,378.00
,"Invoice","10/03/2022","522673","810312-023747 / #23747 ORIGINAL DENIM JEGGING 2XL-3XL (J3047)","KROGER CORPORATE:KROGER LOUISVILLE:KROLO777","LIODJ403-AY (810312-023747 / #23747 ORIGINAL DENIM JEGGING 2XL-3XL (J3047))",4,"EA",10.50,42.00,420.00
,"Invoice","10/17/2022","524023","810312-023693 / #23693 PRINTED SUP SOFT LEG S-L (L9316)","KROGER CORPORATE:KROGER LOUISVILLE:KROLO777","LISSL301-AY (810312-023693 / #23693 PRINTED SUP SOFT LEG S-L (L9316))",17,"EA",4.30,73.10,493.10
,"Invoice","10/17/2022","524023","810312-023709 / #23709 PRINTED SUP SOFT LEG L-XL (L9316)","KROGER CORPORATE:KROGER LOUISVILLE:KROLO777","LISSL302-AY (810312-023709 / #23709 PRINTED SUP SOFT LEG L-XL (L9316))",27,"EA",4.30,116.10,609.20
,"Invoice","10/17/2022","524023","810312-023716 / #23716 PRINTED SUP SOFT LEG 2XL-3XL (L9316)","KROGER CORPORATE:KROGER LOUISVILLE:KROLO777","LISSL303-AY (810312-023716 / #23716 PRINTED SUP SOFT LEG 2XL-3XL (L9316))",4,"EA",4.30,17.20,626.40
"Total KROLO777",,,,,,,88,,,626.40,626.40
"KROLO779",,,,,,,,,,,""
,"Invoice","10/10/2022","523361","810312-023662 / #23662 SOLID SUP SOFT LEG S-L (L6286)","KROGER CORPORATE:KROGER LOUISVILLE:KROLO779","LISSL201-AY (810312-023662 / #23662 SOLID SUP SOFT LEG S-L (L6286))",17,"EA",4.30,73.10,73.10
,"Invoice","10/10/2022","523361","810312-023679 / #23679 SOLID SUP SOFT LEG L-2XL (L6286)","KROGER CORPORATE:KROGER LOUISVILLE:KROLO779","LISSL202-AY (810312-023679 / #23679 SOLID SUP SOFT LEG L-2XL (L6286))",27,"EA",4.30,116.10,189.20
,"Invoice","10/10/2022","523361","810312-023686 / #23686 SOLID SUP SOFT LEG 2XL-3XL (L6286)","KROGER CORPORATE:KROGER LOUISVILLE:KROLO779","LISSL203-AY (810312-023686 / #23686 SOLID SUP SOFT LEG 2XL-3XL (L6286))",4,"EA",4.30,17.20,206.40
,"Invoice","11/07/2022","527961","810312-023723 / #23723 ORIGINAL DENIM JEGGING S-M (J3047)","KROGER CORPORATE:KROGER LOUISVILLE:KROLO779","LIODJ401-AY (810312-023723 / #23723 ORIGINAL DENIM JEGGING S-M (J3047))",13,"EA",10.50,136.50,342.90
,"Invoice","11/07/2022","527961","810312-023730 / #23730 ORIGINAL DENIM JEGGING L-XL (J3047)","KROGER CORPORATE:KROGER LOUISVILLE:KROLO779","LIODJ402-AY (810312-023730 / #23730 ORIGINAL DENIM JEGGING L-XL (J3047))",23,"EA",10.50,241.50,584.40
,"Invoice","11/07/2022","527961","810312-023747 / #23747 ORIGINAL DENIM JEGGING 2XL-3XL (J3047)","KROGER CORPORATE:KROGER LOUISVILLE:KROLO779","LIODJ403-AY (810312-023747 / #23747 ORIGINAL DENIM JEGGING 2XL-3XL (J3047))",4,"EA",10.50,42.00,626.40
"Total KROLO779",,,,,,,88,,,626.40,626.40
"KROLO780",,,,,,,,,,,""
,"Invoice","10/10/2022","523357","810312-023662 / #23662 SOLID SUP SOFT LEG S-L (L6286)","KROGER CORPORATE:KROGER LOUISVILLE:KROLO780","LISSL201-AY (810312-023662 / #23662 SOLID SUP SOFT LEG S-L (L6286))",17,"EA",4.30,73.10,73.10
,"Invoice","10/10/2022","523357","810312-023679 / #23679 SOLID SUP SOFT LEG L-2XL (L6286)","KROGER CORPORATE:KROGER LOUISVILLE:KROLO780","LISSL202-AY (810312-023679 / #23679 SOLID SUP SOFT LEG L-2XL (L6286))",27,"EA",4.30,116.10,189.20
,"Invoice","10/10/2022","523357","810312-023686 / #23686 SOLID SUP SOFT LEG 2XL-3XL (L6286)","KROGER CORPORATE:KROGER LOUISVILLE:KROLO780","LISSL203-AY (810312-023686 / #23686 SOLID SUP SOFT LEG 2XL-3XL (L6286))",4,"EA",4.30,17.20,206.40
,"Invoice","10/24/2022","524500","810312-023693 / #23693 PRINTED SUP SOFT LEG S-L (L9316)","KROGER CORPORATE:KROGER LOUISVILLE:KROLO780","LISSL301-AY (810312-023693 / #23693 PRINTED SUP SOFT LEG S-L (L9316))",17,"EA",4.30,73.10,279.50
,"Invoice","10/24/2022","524500","810312-023709 / #23709 PRINTED SUP SOFT LEG L-XL (L9316)","KROGER CORPORATE:KROGER LOUISVILLE:KROLO780","LISSL302-AY (810312-023709 / #23709 PRINTED SUP SOFT LEG L-XL (L9316))",27,"EA",4.30,116.10,395.60
,"Invoice","10/24/2022","524500","810312-023716 / #23716 PRINTED SUP SOFT LEG 2XL-3XL (L9316)","KROGER CORPORATE:KROGER LOUISVILLE:KROLO780","LISSL303-AY (810312-023716 / #23716 PRINTED SUP SOFT LEG 2XL-3XL (L9316))",4,"EA",4.30,17.20,412.80
,"Invoice","11/07/2022","527959","810312-023723 / #23723 ORIGINAL DENIM JEGGING S-M (J3047)","KROGER CORPORATE:KROGER LOUISVILLE:KROLO780","LIODJ401-AY (810312-023723 / #23723 ORIGINAL DENIM JEGGING S-M (J3047))",13,"EA",10.50,136.50,549.30
,"Invoice","11/07/2022","527959","810312-023730 / #23730 ORIGINAL DENIM JEGGING L-XL (J3047)","KROGER CORPORATE:KROGER LOUISVILLE:KROLO780","LIODJ402-AY (810312-023730 / #23730 ORIGINAL DENIM JEGGING L-XL (J3047))",23,"EA",10.50,241.50,790.80
,"Invoice","11/07/2022","527959","810312-023747 / #23747 ORIGINAL DENIM JEGGING 2XL-3XL (J3047)","KROGER CORPORATE:KROGER LOUISVILLE:KROLO780","LIODJ403-AY (810312-023747 / #23747 ORIGINAL DENIM JEGGING 2XL-3XL (J3047))",4,"EA",10.50,42.00,832.80
"Total KROLO780",,,,,,,136,,,832.80,832.80
"KROLO785",,,,,,,,,,,""
,"Invoice","10/03/2022","522672","810312-023723 / #23723 ORIGINAL DENIM JEGGING S-M (J3047)","KROGER CORPORATE:KROGER LOUISVILLE:KROLO785","LIODJ401-AY (810312-023723 / #23723 ORIGINAL DENIM JEGGING S-M (J3047))",13,"EA",10.50,136.50,136.50
,"Invoice","10/03/2022","522672","810312-023730 / #23730 ORIGINAL DENIM JEGGING L-XL (J3047)","KROGER CORPORATE:KROGER LOUISVILLE:KROLO785","LIODJ402-AY (810312-023730 / #23730 ORIGINAL DENIM JEGGING L-XL (J3047))",23,"EA",10.50,241.50,378.00
,"Invoice","10/03/2022","522672","810312-023747 / #23747 ORIGINAL DENIM JEGGING 2XL-3XL (J3047)","KROGER CORPORATE:KROGER LOUISVILLE:KROLO785","LIODJ403-AY (810312-023747 / #23747 ORIGINAL DENIM JEGGING 2XL-3XL (J3047))",4,"EA",10.50,42.00,420.00
,"Invoice","10/24/2022","524501","810312-023693 / #23693 PRINTED SUP SOFT LEG S-L (L9316)","KROGER CORPORATE:KROGER LOUISVILLE:KROLO785","LISSL301-AY (810312-023693 / #23693 PRINTED SUP SOFT LEG S-L (L9316))",17,"EA",4.30,73.10,493.10
,"Invoice","10/24/2022","524501","810312-023709 / #23709 PRINTED SUP SOFT LEG L-XL (L9316)","KROGER CORPORATE:KROGER LOUISVILLE:KROLO785","LISSL302-AY (810312-023709 / #23709 PRINTED SUP SOFT LEG L-XL (L9316))",27,"EA",4.30,116.10,609.20
,"Invoice","10/24/2022","524501","810312-023716 / #23716 PRINTED SUP SOFT LEG 2XL-3XL (L9316)","KROGER CORPORATE:KROGER LOUISVILLE:KROLO785","LISSL303-AY (810312-023716 / #23716 PRINTED SUP SOFT LEG 2XL-3XL (L9316))",4,"EA",4.30,17.20,626.40
"Total KROLO785",,,,,,,88,,,626.40,626.40
"Total KROGER LOUISVILLE",,,,,,,1904,,,13147.20,13147.20
"Total KROGER CORPORATE",,,,,,,1904,,,13147.20,13147.20
"TOTAL",,,,,,,1904,,,13147.20,13147.20
